1111111111111111111111111
1000000000000000000000001
1000220000000000000000001
1000000000000000000000001
1000000000111100000000001
1000000000111100000000001
1000000000111100000000001
1000000000000000000000001
1000000000000000000000001
1000000000010001000000001
1000000000010001000000001
1000000000011111000000001
1000000000000000000000001
1000000000000000000000001
1000000000000000000000001
1000000000000000000000001
1000111100000000000000001
1000000000000000000000001
1111111111111111111111111
